#########
#     ..#
#   # B #
### #@###
  #B# #
  #   #
  #####